17 11 16 16 75 1
1 2 3 4 5 6 7 8 9 10 11 4 12 13 14 15 1
16 17 18 5 6 19 20 5 16 21 22 5 5 23 24 10 1
25 26 27 28 29 30 31 28 32 8 5 33 34 13 14 15 1
35 36 37 38 5 5 5 38 5 5 38 38 5 23 24 10 1
25 26 39 33 40 28 20 6 41 30 33 30 12 13 14 15 1
35 36 37 38 5 38 6 19 20 5 5 5 5 23 24 10 1
1 42 43 44 33 30 33 45 31 28 29 45 12 13 14 15 1
16 46 47 48 49 5 50 51 49 38 50 51 49 23 24 10 1
1 52 53 54 55 56 57 58 59 56 60 61 55 56 62 15 1
16 63 64 65 66 65 66 65 66 65 67 65 66 65 68 10 1
1 2 69 70 71 72 73 26 74 72 36 70 71 72 73 26 1
